---------------------
-  ----*-   -      --
- --      -   ---- --
- -->-- ---------- --
-    -        ---- --
->- -- --->-- - +- --
- - --     -- - -- --
- -    -- --- -    --
->--- --- --- ---- --
-   - ---      >   --
--- - -   ------ ----
-@- - - ---- >   ----
- - ->-  --  --  ----
-            -   -=--
---------------------